*E*********
*     *   *
* *** * * *
* * * * * *
* * * *** *
* *      H*
***********
